111111111111111111111111
100000000000010000000001
101111111111010111110101
101000000000010000000101
101011111110111110111101
100010000010000010000001
111011101010101011101111
100000100010001000100001
101110111111011111011101
101000000000010000000101
101011111111011111110101
100010000000000000010001
111111111111111111111111


